########################################
#                               ########
###### ########## ######################
###### ########## ######################
######     ###### ######################
########## ###### ######################
########## ###### ######################
###$       ###### ######################
################# ######################
#################           ############
################# ######################
################# ######################
################# ######################
################# ######################
################# ######################
################# ######################
################# ######################
################# ######################
########################################